### B#####
## # # ###
## # # ###
## # # ###
##   # ###
## ### ###
## ### ###
##  #  ###
###   ####
####A#####